Home Village
222222222222222222222222222222222222222222222222222222222
222222222222222222222222222222222222222222222222222222222
222222222222222222222222222222222222222222222222222222222
222222222222222222222222222222222222222222222222222222222
222222222222222222222222222222222222222222222222222222222
222222222222222222222222222222222222222222222222222222222
222222222222222222222222222222222222222222222222222222222
222222222222111100001111000000001111066607000000000000000
222222222222111100001111000006601111000000000000111110000
222222222222111100000000011100601111001110070000111110000
222222222222111100011000011100118110011811000000111110000
222222222222000000000000011100111100001110000600111110000
222222222222000000000000011100001111667666111100006000000
222222222222000000000000011106001111678661111110600000000
222222222222000001111110000000601111667666111100000000000
222222222222000001111110000070000000000000000000000000000
222222222222000001111110000000006001000000600111000000000
222222222222000001111110070000000000000010000111000000000
222222222222111001111110000011100000000111000000000000000
222222222222111001111110000111110000001101100000000111100
222222222222111001111110000011100000011111110000000111100
222222222222111001111110070000000000000000000000600000000
222222222222000000000000000000000000000000000000000000000
222222222222000000000600000000100100002222000000000000000
222222222222000000000000000000100100000000000000600000000
222222222222000006000000000010000001000000000000000000000
222222222222000000000000000001000010000000008111100000000
222222222222000011000000000000111100000000001111110000000
222222222222000111100000000000000000000000000111100000000
222222222222000111100000000000000070000000000000000000000
222222222222000011000000006001110000000060000000000000000
222222222222000000000000000001110000000000000000000000001
